hello=привіт
hi=привіт
good morning=доброго ранку
good evening=доброго вечора
good night=доброї ночі
bye=бувай
goodbye=до побачення
yes=так
no=ні
please=будь ласка
thank you=дякую
thanks=дякую
i=я
you=ти
he=він
she=вона
we=ми
they=вони
my=мій
your=твій
cat=кішка
dog=собака
home=дім
house=будинок
friend=друг
love=люблю
like=подобається
want=хочу
java=джава
programming=програмування
computer=комп'ютер
phone=телефон
ukraine=Україна
kyiv=Київ
today=сьогодні
tomorrow=завтра
yesterday=вчора
very=дуже
big=великий
small=маленький
beautiful=гарний
happy=щасливий
time=час
money=гроші
water=вода
coffee=кава
the=
a=
an=
and=і
but=але
because=бо
mouse=миша
kitten=кошеня
